2 19 30
##############################
#p                           #
# **##W       f#   **        #
#   #        *  # #  F   4   #
#   b        #   x   #       #
#   #     4   #     b        #
#   f          b   #   2     #
#   #           # #  1       #
# ##s#*          x           #
#                            #
#      b   #   #*#f#   *##*F #
#  1   #   #   #      3  #   #
#      #   #   #         *   #
#      W   b   x##f#     #   #
#      #   #   #         B   #
#      *   #   # 1       #   #
#  2    ##F    s#b#*     h   #
#                            #
##############################
